                           |###|                            
 |-| |-------------------| |###| |-------------------| |-|  
 |#| |-------------------| |###| |-------------------| |#|  
 |#|                       |###|                       |#|  
 |#---------| |-------------###-------------| |---------#|  
 |----------| |-----------------------------| |----------|  
                                                            
--------| |--------------------------------------| |--------
--------| |--------------------------------------| |--------
                                                            
 |------| |--| |----------         ---------| |--| |------| 
 |######| |##| |             | |            | |##| |######| 
 |######| |##| |                            | |##| |######| 
 |######| |##| |                            | |##| |######| 
 |######| |##| |----------------------------| |##| |######| 
 |######| |##|                                |##| |######| 
 |######| |##| |--| |-------------------| |-| |##| |######| 
 |------| |##| |--| |-------------------| |-| |##| |------| 
          |##|               |#|              |##|          
--------- |--| ------------------------------ |--| ---------
                                                            
 |---------| || |--------------------------| || |---------| 
 |#########| || |--------------------------| || |#########| 
 |---------| ||                              || |---------| 
                |--------------------------|                
----------- |-| |-----------#####----------| |-| -----------
            |#|            |#####|           |#|            
 |----------|#|----------| |#####| |---------|#|----------| 
 |-----------------------| |-----| |----------------------| 
                                                            